1111111111
1P010C00E1
1100010101
11111C0001
1CC0111101
11100C0001
1111111111