11111111111111111111
111E11C00100000000C1
111010C1000111101111
111C1011111111101111
10001CC001CC111000C1
10111CC101101C111011
10000000011000E11011
1111111100001111P011
11111111111111111111