111111
100001
100001
1PCE01
111111
